11,11,11,11,11,11,11,11,11,11,11,11,11,11,11,11,11,11,11,11,11,11,11,11,11,11,11,11,7,7,7,7,7,7,7,7,7,7,7,7,7,7
11,7,7,7,7,7,7,7,7,7,7,7,7,7,7,7,7,7,7,7,7,7,7,7,7,7,7,11,7,7,7,7,7,7,7,7,7,7,7,7,7,7
11,7,7,7,7,7,5,7,7,7,7,7,7,7,7,7,7,11,7,7,7,7,7,7,7,7,7,11,7,7,7,7,7,7,7,7,7,7,7,7,7,7
11,7,7,7,7,11,7,7,7,7,7,7,7,7,11,11,11,11,7,7,7,7,7,7,7,7,7,11,7,7,7,7,7,7,7,7,7,7,7,7,7,7
11,7,7,7,7,11,7,7,7,7,7,7,11,11,7,7,7,7,7,5,7,7,7,7,7,7,7,11,7,7,7,7,7,7,7,7,7,7,7,7,7,7
11,7,7,7,7,11,7,7,7,7,7,7,7,7,7,7,7,7,11,11,7,7,7,7,7,7,7,11,7,7,7,7,7,7,7,7,7,7,7,7,7,7
11,7,7,7,7,11,7,7,7,7,7,7,7,7,7,7,7,11,11,7,7,7,7,7,7,7,7,11,7,7,7,7,7,7,7,7,7,7,7,7,7,7
11,7,7,7,7,11,7,7,7,7,7,7,7,7,7,7,7,11,7,7,7,7,7,7,7,7,7,11,11,7,7,7,7,7,7,7,7,7,7,7,7,7
11,7,7,7,7,11,7,7,7,7,7,7,7,7,7,7,11,11,7,7,7,7,7,7,7,7,7,11,11,7,7,7,7,7,7,7,7,7,7,7,7,7
11,7,7,7,7,11,7,7,7,7,7,7,7,7,7,7,11,7,7,7,7,7,7,7,7,7,7,11,11,7,7,7,7,7,7,7,7,7,7,7,7,7
11,7,7,7,7,11,7,7,7,7,7,7,7,7,7,11,11,7,7,7,7,7,7,7,7,7,7,11,7,7,7,7,7,7,7,7,7,7,7,7,7,7
11,7,7,7,7,11,7,7,7,7,7,7,7,11,11,11,7,7,7,7,7,7,7,7,7,7,7,11,7,7,7,7,7,7,7,7,7,7,7,7,7,7
11,7,7,7,7,7,7,7,7,7,7,11,11,11,7,7,7,7,7,7,7,7,7,7,7,7,7,11,7,7,7,7,7,7,7,7,7,7,7,7,7,7
11,7,7,7,7,7,7,7,7,7,5,7,7,7,7,7,7,7,7,7,7,7,7,7,7,7,7,11,7,7,7,7,7,7,7,7,7,7,7,7,7,7
11,7,7,7,7,7,7,7,7,7,7,7,7,7,7,7,7,7,7,7,7,7,7,7,7,7,7,11,7,7,7,7,7,7,7,7,7,7,7,7,7,7
11,7,7,7,7,7,7,7,7,7,7,7,7,7,7,7,7,7,7,7,7,7,7,7,7,7,7,11,7,7,7,7,7,7,7,7,7,7,7,7,7,7
11,11,11,11,11,11,7,7,7,7,7,7,7,7,7,7,7,7,7,7,7,7,7,7,7,7,7,11,7,7,7,7,7,7,7,7,7,7,7,7,7,7
11,11,11,11,11,11,11,11,11,11,11,11,11,11,11,11,11,11,11,11,11,11,11,11,11,11,11,11,7,7,7,7,7,7,7,7,7,7,7,7,7,7
7,7,7,7,7,7,7,7,7,7,7,7,7,7,7,7,7,7,7,7,7,7,7,7,7,7,7,7,7,7,7,7,7,7,7,7,7,7,7,7,7,7
7,7,7,7,7,7,7,7,7,7,7,7,7,7,7,7,7,7,7,7,7,7,7,7,7,7,7,7,7,7,7,7,7,7,7,7,7,7,7,7,7,7
7,7,7,7,7,7,7,7,7,7,7,7,7,7,7,7,7,7,7,7,7,7,7,7,7,7,7,7,7,7,7,7,7,7,7,7,7,7,7,7,7,7
7,7,7,7,7,7,7,7,7,7,7,7,7,7,7,7,7,7,7,7,7,7,7,7,7,7,7,7,7,7,7,7,7,7,7,7,7,7,7,7,7,7
7,7,7,7,7,7,7,7,7,7,7,7,7,7,7,7,7,7,7,7,7,7,7,7,7,7,7,7,7,7,7,7,7,7,7,7,7,7,7,7,7,7
7,7,7,7,7,7,7,7,7,7,7,7,7,7,7,7,7,7,7,7,7,7,7,7,7,7,7,7,7,7,7,7,7,7,7,7,7,7,7,7,7,7
7,7,7,7,7,7,7,7,7,7,7,7,7,7,7,7,7,7,7,7,7,7,7,7,7,7,7,7,7,7,7,7,7,7,7,7,7,7,7,7,7,7
7,7,7,7,7,7,7,7,7,7,7,7,7,7,7,7,7,7,7,7,7,7,7,7,7,7,7,7,7,7,7,7,7,7,7,7,7,7,7,7,7,7
7,7,7,7,7,7,7,7,7,7,7,7,7,7,7,7,7,7,7,7,7,7,7,7,7,7,7,7,7,7,7,7,7,7,7,7,7,7,7,7,7,7
7,7,7,7,7,7,7,7,7,7,7,7,7,7,7,7,7,7,7,7,7,7,7,7,7,7,7,7,7,7,7,7,7,7,7,7,7,7,7,7,7,7
7,7,7,7,7,7,7,7,7,7,7,7,7,7,7,7,7,7,7,7,7,7,7,7,7,7,7,7,7,7,7,7,7,7,7,7,7,7,7,7,7,7
7,7,7,7,7,7,7,7,7,7,7,7,7,7,7,7,7,7,7,7,7,7,7,7,7,7,7,7,7,7,7,7,7,7,7,7,7,7,7,7,7,7
7,7,7,7,7,7,7,7,7,7,7,7,7,7,7,7,7,7,7,7,7,7,7,7,7,7,7,7,7,7,7,7,7,7,7,7,7,7,7,7,7,7
